#############
A #     #   #
# # ### # # #
# # # # # # #
#   # # #   B
#############
